15,2,10,10,3,10,10,6,11,6
7,1,11,10,8,3,10,9,10,4
5,9,2,3,10,8,10,10,10,12
5,3,0,9,2,3,2,10,10,14
5,1,1,3,8,1,9,3,10,6
5,1,1,1,3,1,2,1,3,4
5,1,9,1,9,8,1,1,5,5
5,1,2,9,2,3,8,1,5,5
5,7,1,2,1,9,10,8,5,5
1,0,6,1,0,10,10,10,12,13
