3,14,3,10,10,10,10,2,10,6
5,3,12,11,2,3,2,9,3,4
5,9,2,10,8,1,9,2,5,13
1,14,5,3,2,9,2,1,9,6
1,2,0,1,9,10,8,5,3,12
3,2,2,1,3,3,10,8,9,6
5,3,0,0,1,1,3,2,3,12
5,7,3,2,0,1,1,1,9,6
5,5,1,2,1,1,8,9,6,5
9,8,11,8,9,10,10,10,8,12
