7,11,2,14,3,10,3,2,2,14
5,11,0,2,8,2,4,13,13,7
1,10,12,9,11,8,9,2,14,5
13,11,6,3,2,10,10,0,14,5
3,10,8,0,9,3,10,0,14,5
13,11,10,0,3,8,11,0,10,5
11,10,2,0,1,3,3,1,2,13
3,2,4,9,9,1,0,0,9,6
13,5,13,11,10,8,1,1,11,4
11,12,11,10,10,10,8,9,11,12
