15,3,11,2,3,10,6,7,3,14
11,1,11,8,0,10,9,8,0,14
3,0,10,10,9,11,6,3,8,14
9,1,11,2,14,3,8,0,10,6
3,0,2,8,2,12,11,0,14,13
5,5,5,11,8,14,11,4,3,14
5,5,5,11,10,2,2,8,8,6
5,13,1,6,11,12,1,6,3,12
1,6,13,5,3,10,4,5,1,6
5,1,6,5,5,11,12,13,13,13
