3,2,10,10,10,10,6,11,2,6
1,5,3,10,10,6,9,6,13,5
5,9,8,10,14,5,3,8,10,4
5,3,6,3,10,12,13,3,6,13
9,12,5,9,10,10,10,12,9,6
3,14,9,10,10,10,2,14,3,12
1,6,3,10,2,14,5,3,12,7
5,9,12,7,9,10,12,13,3,4
9,6,3,4,3,10,10,6,13,5
11,8,12,9,12,11,10,8,10,12
