7,3,10,14,3,2,10,14,11,14
5,1,14,11,4,9,6,11,10,6
1,0,2,14,13,11,0,14,3,12
5,13,9,2,10,10,4,7,5,7
9,14,11,12,3,10,8,0,8,12
3,6,3,10,8,7,11,4,3,14
3,0,2,10,2,1,2,0,0,14
3,0,3,2,0,0,1,13,9,6
3,2,2,0,1,1,1,2,6,5
10,10,8,9,3,8,1,9,1,13
