7,11,2,10,3,10,3,6,2,15
5,11,0,2,8,2,4,13,5,15
1,10,8,9,11,8,9,2,14,5
13,11,2,3,2,10,10,0,14,5
3,10,8,0,9,3,10,0,14,5
5,3,2,0,3,8,11,0,14,5
3,2,2,0,1,3,3,1,6,13
3,2,0,1,9,1,0,4,9,6
5,1,1,3,10,8,1,5,11,4
3,0,3,2,10,10,8,9,11,12
