15,11,10,10,10,10,6,11,2,7
11,3,3,10,10,6,9,6,13,1
3,9,8,10,10,5,3,8,10,4
8,3,2,3,10,12,13,3,6,13
8,8,1,9,10,10,10,12,9,6
2,10,9,10,10,10,2,14,3,12
1,6,3,10,2,14,5,3,12,7
5,9,12,7,9,10,12,13,3,4
9,6,3,4,3,10,10,6,13,5
3,0,4,1,4,11,10,8,10,12
