3,14,3,10,10,10,10,2,10,6
5,3,12,11,6,3,2,9,3,4
5,9,2,10,12,1,9,2,1,13
1,14,5,3,6,9,2,1,9,6
9,10,12,5,9,10,8,1,3,8
3,10,6,5,7,3,10,8,9,2
5,11,8,12,1,1,3,2,3,12
5,7,3,10,4,1,1,1,9,6
5,5,9,6,5,1,0,1,2,5
9,12,11,12,9,10,10,10,8,12
