7,11,2,10,10,10,6,3,14,7
5,7,13,3,3,11,0,4,3,12
1,12,3,9,0,3,9,5,1,14
1,10,1,2,1,0,3,1,5,7
1,10,9,1,9,9,0,8,8,12
9,10,2,9,10,2,8,2,10,14
7,3,0,3,11,8,3,1,10,14
1,0,9,9,10,2,8,0,2,14
3,0,2,2,11,0,11,8,1,14
1,1,3,8,2,8,10,10,9,14
