15,11,10,10,10,10,6,11,2,7
15,1,1,10,10,6,9,6,13,5
3,9,8,8,12,5,3,8,10,4
5,1,4,1,8,12,13,1,4,13
9,12,5,9,8,8,8,12,9,6
3,14,9,8,8,8,0,14,3,12
1,6,3,10,0,12,5,3,12,7
5,9,12,7,9,10,12,13,3,4
9,6,3,4,3,10,10,6,9,5
11,8,12,9,12,11,10,8,10,8
