7,3,10,14,3,2,10,14,11,14
5,1,14,11,4,9,6,11,10,6
1,0,2,2,1,11,0,14,3,12
5,1,1,2,2,2,4,7,5,7
1,2,3,0,3,2,0,0,8,12
3,2,3,2,0,3,3,4,3,14
3,0,2,2,2,1,2,0,0,14
3,0,3,2,0,0,1,13,9,6
3,2,2,0,1,1,1,2,6,5
3,2,0,1,3,8,9,9,13,13
