15,7,11,6,3,10,6,7,3,14
7,5,11,8,0,14,9,8,0,14
1,0,10,14,13,11,6,3,8,14
13,5,11,2,14,3,8,0,10,6
3,0,2,8,2,12,11,0,14,9
5,5,5,11,8,14,11,4,3,10
5,5,5,11,10,2,2,8,8,2
5,13,1,6,11,12,1,6,3,12
1,6,13,5,3,10,4,5,1,6
13,9,14,13,13,11,12,13,13,13
