11,2,10,14,3,10,10,2,11,6
5,5,11,10,8,3,10,9,10,4
5,9,6,3,10,8,10,10,10,12
5,3,4,9,2,3,2,10,10,14
5,5,5,3,8,1,9,3,10,6
5,5,5,5,3,1,2,1,3,4
5,5,13,5,9,8,1,1,1,5
5,9,6,9,2,3,8,1,1,5
5,7,9,6,1,9,10,8,1,1
9,8,14,9,8,10,10,10,8,13
