7,3,6,3,6,3,10,2,10,6
1,12,9,12,9,12,3,12,7,7
9,10,10,6,7,3,12,11,4,5
3,6,3,12,5,9,10,6,5,5
5,9,8,14,1,2,14,5,1,12
5,11,2,2,12,5,3,12,5,7
9,6,5,5,11,4,9,6,9,4
3,12,13,9,6,9,6,5,3,5
5,3,10,6,5,11,12,5,5,5
9,12,11,8,12,11,10,4,1,4
