7,3,10,14,3,2,10,14,11,6
5,1,14,11,4,9,6,11,10,6
1,0,2,2,1,3,0,14,3,12
5,1,1,2,2,2,4,7,5,7
1,2,3,0,3,2,0,0,8,12
3,2,3,2,0,3,3,4,3,14
2,0,2,2,2,1,2,0,0,14
2,0,3,2,0,0,1,13,9,6
0,2,2,0,1,1,1,2,6,5
2,2,0,0,2,8,9,9,13,13
