7,11,2,10,10,10,6,3,14,7
5,7,13,7,7,11,0,0,3,12
1,12,7,9,4,3,9,1,1,14
1,14,1,6,1,0,3,1,1,7
1,14,13,1,9,9,0,8,8,12
9,10,6,9,10,2,8,2,10,14
7,3,4,3,11,8,3,1,10,10
9,4,13,9,10,2,8,0,2,14
3,0,10,2,11,0,11,8,1,14
13,13,11,8,10,8,10,10,9,14
