7,3,10,10,6,3,10,6,3,6
1,12,3,10,12,5,7,9,12,5
1,14,9,6,7,5,9,10,6,5
5,3,6,5,5,9,6,3,12,5
5,5,9,12,1,14,9,4,3,4
5,9,6,7,1,10,10,12,5,13
9,6,5,1,8,8,8,12,9,6
7,5,5,9,4,1,4,1,4,5
5,5,9,14,13,5,9,12,5,5
9,8,10,10,10,12,11,10,8,12
